W W W W W W W W W W W W
W M T P P P P W W W W W
W W W W W W P W W W W W
W W W W P P P W W W W W
W W W W W W P W W W W W
W W W W W W P P P P P W
W W W W W W P W W W W W
W P P P P P P W W W W W
W W W W W W P W W W W W
W W W W W W P P P P W W
W W W W P P P W W W W W
W W W W D W W W W W W W